[
	["w", "w", "w", "w", "w", "w"],
	["o", "o", "o", "o", "o", "o"],
	["w", "w", "w", "o", "o", "w"],
	["w", "o", "w", "o", "o", "w"],
	["w", "o", "o", "o", "o", "w"],
	["w", "w", "w", "w", "w", "w"]
]